NO ./pics/walls/wall_04.xpm
SO ./pics/walls/wall_06.xpm

WE ./pics/walls/wall_07.xpm
EA     ./pics/walls/wall_14.xpm

F 80,80,80
F 80,80,80
F 80,80,80


C  85,183,208

11111111111111111111111
10000000000000000000001
10111111111111111111101
101                 101
101   11111111     11711
101   100000011111111001
101  11001000000000000011111111
101  100000001111110Z00000000011
1011110000000000000000111100000111111111
1000070000010000000000000000000200000001
11111111100000000N0000011110000111111101
        1000000000000001  111111     101
        1111111111112111             101
                   101111111111111111101
                   100000000000000000001
                   111111111111111111111
